15 10
###############
#....#..#.....#
#....#........#
#.#####.####.##
#.#.....#.....#
#.....#.#.....#
#.#...#.#..#..#
#.###.#.#.....#
#.......#.....#
###############
